########
#AB#C D#
#^#### #
#E F  G#
### ## #
#H I#JK#
#L#M# ##
#####N##
